
F 220,100, 0  
C 102, 191, 255


NO ./textures/greystone.xpm     
WE ./textures/redbrick.xpm
EA ./textures/bluestone.xpm            
SO ./textures/purplestone.xpm



111111111111111111111111
100000000000000000000001
100000000000000000000001
100000000000000000000001
100000000000000000000001
100000000000000000000001
100000000000000000000001
100000000000000000000001
100000000000000000000001
100000000000000000000001
100000000000000000000001
100000000000000000000001
1000000000X0000000000001
100000000000000000000001
100000000000000000000001
100000000000000000000001
100000000000000000000001
100000000000000000000001
100000000000000000000001
100000000000000000000001
100000000000000000000001
100000000000000000000001
100000000000000000000001
111111111111111111111111
