

F 220,100,0          
C 0,30,0


NO ./textures/file.xpm     
WE ./textures/file.xpm
EA ./textures/file.xpm            
SO ./textures/file.xpm

        1111111111111111111111111
        1110000000110000000000001
        1111000001110000000000001
        1001000000000000000000001
111111111011000001110000000000001
100000000011000001110111111111111
11110111111111011100000010001
11110111111111011111010010001
11000001110101011100000010001
10000000000000001100000010001
100000000000000110101N010001
1100000101010101111101111010111
11110111 1110101 101111010001
11111111 1111111 111111111111
