

F 126,36, 92  
C 121,206,184


NO ./textures/greystone.xpm     
WE ./textures/redbrick.xpm
EA ./textures/bluestone.xpm            
SO ./textures/purplestone.xpm

        1111111111111111111111111
        11N0000000110000000000001
        1111000001110000000000001
        1001000000000000000000001
111111111011010001110000000000001
100000000011000001110111111111111
11110111111111011100000010001
11110111111111011111010010001
11000001110101011100000010001
10000000000000001100000010001
10000001000000011010111010001
1100000111010101111101111010111
11110111 1110101 101111010001
11111111 1111111 111111111111
